I                                                          L
C                   0                                      E
C                  aM                                      E
C                 aM                         a             E
C                aM                         aaa            E
C               aM          aaa            aaaaa           E
C         0    aM          aLBIa          aaaaaaa          E
C         Ma   M    0    aaLGAFIaa       aaaaaaaaa         E
C          Ma      aM   LBBGAAAFBBI    LBBBBBBBBBBBI       E
C           Ma    aM    KDDDDDDDDDJ    KDDDDDDDDDDDJ       E
C            M   aM                                        E
C               aM                                         E
C               M                                          E
C                                                          E
C            M   0    M   0    0                           E
FBBBBBBBBBBBBBBBBBBBBBBBBBBBBBBBBBBBBBBBBBBBBBBBBBBBBBBBBBBG
AAAAAAAAAAAAAAAAAAAAAAAAAAAAAAAAAAAAAAAAAAAAAAAAAAAAAAAAAAAA