I                                                          L
C                                                          E
C                   M                                      E
C                  M                                       E
C                 M                                        E
C                M                                         E
C               M           LBI                            E
C         M    M           LGAFI                           E
C          M        M   LBBGAAAFBBI    LBBBBBBBBBBI        E
C           M      M    KDDDDDDDDDJ    KDDDDDDDDDDJ        E
C            M    M                                        E
C                M                                         E
C               M                                          E
C            rrr                                           E
C            rrr                                           E
FBBBBBBBBBBBBBBBBBBBBBBBBBBBBBBBBBBBBBBBBBBBBBBBBBBBBBBBBBBG
AAAAAAAAAAAAAAAAAAAAAAAAAAAAAAAAAAAAAAAAAAAAAAAAAAAAAAAAAAAA