C                                                          E
C                                                          E
C                   Q                                      E
C                  Q                                       E
C                 Q                                        E
C                Q                                         E
C               Q           MBJ                            E
C         Q    Q           MGAFJ                           E
C          Q        Q   MBBGAAAFBBJ                        E
C           Q      Q    LDDDDDDDDDK    NOOOOOOOOOOP        E
C            Q    Q                                        E
C                Q                                         E
C               Q                                          E
C              Q                                           E
C             Q                                            E
FBBBBBBBBBBBBBBBBBBBBBBBBBBBBBBBBBBBBBBBBBBBBBBBBBBBBBBBBBBG
AAAAAAAAAAAAAAAAAAAAAAAAAAAAAAAAAAAAAAAAAAAAAAAAAAAAAAAAAAAA